1111111111111111111111111111111111
1E0000000000000C00000C0000E0000001
101001010010C000101001000000010101
10100100101010100010010000E0010101
100000000C00C0000000000000000000C1
1111111111111111111111111111111111
