1111111111111111111111111111111111
1111111111111111111111111111111111
1CCCCCCCCCCCCCCCCCCCCCCCCCCCCCCCC1
1CCCCCCCCCCCCCCCCCCNCCCCCCCCCCCCC1
1CCCCCCCCCCCCCCCCCCCCCCCCCCECCCCC1
11111111111111111111P1111111111111
1111111111111111111111111111111111
