1111111111111111111111111111111111
1E00000000000P0C00000C000N00000001
101001010010000010100100P000010101
1010010010101010001001000000010101
1P0000000C00C0000000N00000000000C1
1111111111111111111111111111111111
