1111111111111111111111111111111111
1000E000N00000111000N0000000C00001
1000N000C00010000C000N000C10000001
10000N00001000000C00000C0000000001
101001001010101000100100N000010101
1P0000000N000C0000000000N0000000C1
1111111111111111111111111111111111
