1111111111111111111111111111111111
1NCCCCCCNCCC111CCCCCCCCCCCCCCCCCC1
1C1CC1CC1CNC1C1CCC1CC1CCCCCCC1C1C1
1NCCCCCC1CCCCCCC1CNCCCC1CCC1CCCCC1
1C1CC1CC1CNC1C1CCC1CC1CCCC1CC1C1C1
1NCCCCCCCCC1CCCCCCNCCCCC1CECCCCCC1
1C1CC1C1CCCCCCCC1C1CC1CCNCCCC1C1C1
1C1CC1C1CC1CCCCC1C1C1CCCNCCCC1C1C1
1C1CC1C1CCNCCCCC1C1CC1CCNCCCC1C1C1
1C1CC1CC1CNC1C1CCC1C1CCCCC1CC1C111
1C1CC1CC1CNC1C1CCC1CC1CCCC1CC1C1C1
1NCCCCCCCCC1CCCCCCNCCCCC1CNCCCCCC1
1C1CC1CC1CNC1C1CCC1CC1CCCC1CC1C1C1
1NCCCCCCC1CCCCCCCCCCCCCCCCCCCCCCC1
1C1CC1CC1C1C1C1CCC1CC1CCCCCCC1C1C1
1NCCCCCCCCNCCCCCCNCCCCC111CCCCCCC1
1C1CC1CC1C1C1C1CCC1CC1CCCCCCC1C1C1
1PCCCCCCCNCCCCCCCCNCCCCCNCCCCCCCC1
1NCCCCCCC1CCCCCCCCCCCCCCCCCCCCCCC1
1111111111111111111111111111111111
