111111111111111111111111111111111111
1010N0100NC00N0010001001000N00010101
10100000N0C00N00000N0000000N000000C1
1010010010N010100010010000N001010N01
100N000000N000001000N01000N00C00N001
1010010N010N0C010001001000N000010101
10100100101010100010010000N00010N001
1010010100N0000010100100N000010N0001
1010010010N0101000100100000N00101001
1000C000N0000010EN00001000000N000001
1000000N0000N0000N000C0000N0000NC001
1010010010101010N0010010000000101001
1010010100N0000010100100N00001010001
10N000000N000010N00010C00N0000N00001
10100N001010101000100100000001010001
1P000000N100N00000N00000N0000000N001
101001001110N010001001000N0001010001
1000000N00000N000E00N000000NCN000001
111111111111111111111111111111111111
