11111
1CCC1
1E1C1
1P111
11111
