1111111111111111111111111111111111
1ECCCCCCCCCCCCCCCCCCCCCCCCECCCCCC1
1C1CC1C1CC1CCCCC1C1CC1CCCCCCC1C1C1
1C1CC1CC1C1C1C1CCC1CC1CCCCECC1C1C1
1PCCCCCCCCCCCCCCCCCCCCCCCCCCCCCCC1
1111111111111111111111111111111111
