1111111111111111111111111111111111
1000000000001110000000000C00000001
1010010010001010001001000000010101
1000000010000000100000010001000001
1010010010001010001001000010010101
1000000C00010000C000000C10E0000001
1010010100C00000101001000000010101
1010010100100000101010000000010101
1010010010001010001001000010010101
1000000C00010000C000000C1000000001
1010010010001010001001000010010101
1000000001000000C00000C00000000001
1010010010101010001001000000010101
100000000000000C00000C011100000001
1010010010101010001001000000010101
1P0000000000C0000000000000000000C1
1000000001000000C00000C00000000001
1111111111111111111111111111111111
