1111111111111111111111111111111111
1E000000N0000000000000000N00000001
1010010010N01010001001000000010101
1E0000000N000001000001000000000001
1010010100N0000010100100N000010101
1010010010N01010001001000000010101
1E0000000N000001000001000000N00001
1010010010101010001001000000010101
1E00000000N000010N00010C00N0000001
1010010010101010001001000000010101
1P0000000N00N00000N00000N0000000N1
1111111111111111111111111111111111
